0 1 2 2
16 16
  1 1 1 1 1 1 2 3 2 1 1 2 4 4 4 4
1 1 1 1 1 1 2 3 3 2 1 1 2 2 2 4
  1 1 1 1 1 1 2 2 2 1 1 1 2 2 4 4
2 1 1 1 1 1 1 1 1 1 1 1 2 2 4 4
  2 1 1 1 1 1 1 1 1 1 1 2 4 4 4 4
4 2 1 1 1 1 1 1 1 1 1 1 2 2 4 4
  2 1 1 1 1 1 1 2 2 2 1 1 1 2 4 4
2 1 1 1 1 1 1 2 3 3 2 1 1 1 2 4
  1 1 1 1 1 1 2 3 3 3 2 1 1 2 2 4
2 1 1 1 1 1 2 3 3 2 2 1 1 2 2 4
  2 2 1 1 1 2 2 2 2 2 1 1 2 2 4 4
4 4 2 1 1 1 1 1 1 1 1 1 2 2 4 4
  4 2 1 1 1 1 1 1 1 1 2 2 4 4 4 4
2 2 1 1 1 1 1 1 1 2 2 4 4 4 4 4
  2 1 1 1 1 1 1 1 2 2 4 4 4 4 4 4
1 1 1 1 1 1 1 2 2 4 4 4 4 4 4 4

첫째 줄: 0, 전함 수, 순양함 수, 구축함 수
둘째 줄: 맵 가로, 세로 크기
셋째 줄~: 지형
1: 바다 Ocean
2: 연안 Shore (대형함 이동 불가, 잠수함 잠항 불가)
3: 섬 Island (건너편 시야 및 포격 차단)
4: 육지 Land
※ 오류 발생 시 중간 공백이 2개 이상인지 확인 (각 줄의 시작과 끝은 무관)